111111111111111
10E0C000P000001
101000001000001
100V000000V0001
10V00C0100V0001
10V1000C0000001
10010V000000V01
1001000V0C00001
10V010000000C01
111111111111111